###################
#...###.####..........
#...###.####
#..##.#.####
#.##..#.#..#
###........#
##...@..#..#
####..###..#
#..#..#....#
#.##.##.#.##
#.#......##
#.#....!##
#.#######