.............................................
.............................................
.............................................
.............................................
.............................................
.............................................
.............................................
.........................................................
.............................................
.............................................
.............................................
.............................................
.............................................
.............................................
.............................................
.............................................
.............................................
.............................................
.............................................
.............................................
.............................................
.............................................
.............................................
....................#########################
....................#.......................#
....................#.#####################.#
....................#.#...................#.#
....................#.#.###############.#.#.#
....................#.#.#.............#.#.#.#
....................#.#.#.#########.#.#.#.#.#
....................#.#.#.#.......#.#.#.#.#.#
....................#.#.#.#.#####.#.#.#.#.#.#
....................#.#.#.#.#...#.#.#.#.#.#.#
....................#.#.#.#.#.#.#.#.#.#.#.#.#
....................#.#.#.#.#.#.#.#.#.#.#.#.#
....................#.#.#.#.#.#.#.#.#.#.#.#.#
....................#.#.#.#.#.#.#.#.#.#.#.#.#
....................#.#.#.#.#.#.#.#.#.#.#.#.#
....................#.#.#.#.#.#.#.#.#.#.#.#.#
....................#.#.#.#.#.#.#.#.#.#.#.#.#
....................#.#.#.#.#.#.#.#.#.#.#.#.#
....................#.#.#.#.#.#.#.#.#.#.#.#.#
....................#.#.#.#.#.#.#.#.#.#.#.#.#
....................#.#.#.#.#.#.#.#.#.#.#.#.#
....................#.#.#.#.#.#.#.#.#.#.#.#.#
....................#.#.#.#.#.#.#.#.#.#.#.#.#
....................#.#.#.#.#.#.#.#.#.#.#.#.#
....................#.@.#.#.#.#.#.#.#.#.#.!.#
#############################################
.........................
.
.
.
.
.